<level width="1280" height="960" test="0" NewValue0="0">
  <Hazards exportMode="Bitstring">0000000000000000000000000000000000000000
0000000000000000000000000000000000000000
0000000000000000000000000000000000000000
0000000000000000000000000000000000000000
0000000000000000000000000000000000000000
0000000000000000000000000000000000000000
0000000000000000000000000000000000000000
0000000000000000000000000000000000000000
0000000000000000000000000000000000000000
0000000000000000000000000000000000000000
0000000000000000000000000000000000000000
0000000000000000000000000000000000000000
0000000000000000000000000000000000000000
0000000000000000000000000000000000000000
0000000000000000000000000000000000000000
0000000000000000000000000000000000000000
0000000000000000000000000000000000000000
0000000000000000000000000000000000000000
0000000000000000000000000000000000000000
0000000000000000000000000000000000000000
0000000000000000000000000000000000000000
0000000000000000000000000000000000000000
0000000000000000000000000000000000000000
0000000000000000000000000000000000000000
0000000000000000000000000000000000000000
0000000000000000000000000000000000000000
0000000000000000000000000000000000000000
0000000000000000000000000000000000000000
0000000000000000000000000000000000000000
0000000000000000000000000110000000000000</Hazards>
  <Ground exportMode="Bitstring">1111111111111111111111111111110000000000
1111111111111111111111111111111110000000
1111111111111111111111111111111111000000
1111111111111111111111111111111111000000
1111111111111111111111111111111111000000
1111111111111111111111111111111111000000
1111111111111111111111111111111110000000
1111111111111111111111111111111110000000
1000111111111111111111111111111000000000
1000011111111111111111111111000000000000
1000000111111111111111111111111110000000
1000000000000000000000000111111110000000
1000000000000000000000000000001110000000
1000000000000000000000000000000000000000
1000000000000000000000000000000000011000
1000000000000000000000000000000000000001
1000000000000000000000000000000000000001
1000000000000000000000000000000000000011
1110000000000000000000000000000000000011
1111000000000000000000000000000000000111
1111000000000000000000000000000000000111
1111111000000000000000000000000000011111
1111111000000000000000000000000000011111
1111111000000000000000000000000000111111
1111111100000000000000000000000000111111
1111111110000000000000000000000001111111
1111111111110000000000000000000011111111
1111111111111000000000000001100111111111
1111111111111111111111111001111111111111
1111111111111111111111111001111111111111</Ground>
  <Entities>
    <player id="0" x="64" y="560" />
  </Entities>
</level>